_	_
sp	sp
sil	sil
spn	spn
!	!
?	?
…	…
,	,
.	.
-	-
#	#
tsJA	tsJA
fJA	fJA
shJA	shJA
ryJA	ryJA
pyJA	pyJA
hJA	hJA
pJA	pJA
NJA	NJA
aJA	aJA
mJA	mJA
wJA	wJA
kyJA	kyJA
nJA	nJA
dJA	dJA
jJA	jJA
clJA	clJA
nyJA	nyJA
zJA	zJA
oJA	oJA
yJA	yJA
tJA	tJA
uJA	uJA
rJA	rJA
pau	pau
chJA	chJA
eJA	eJA
bJA	bJA
kJA	kJA
gJA	gJA
sJA	sJA
iJA	iJA
gyJA	gyJA
myJA	myJA
hyJA	hyJA
br	br
byJA	byJA
vJA	vJA
tyJA	tyJA
xxJA	xxJA
UJA	UJA
IJA	IJA
dyJA	dyJA
